20 20
.........X.........T
XX...XX...XX...XX...
X.........X.........
XXXXXXX...XXXXXXX...
....XG........XG....
XX..XGX...XX..XGX...
....XXX.......XXX...
XX...XX...XX...XX.K.
X...................
XX...XX...XX...XX...
.........X..........
XX...XX...XX...XX...
X.........X.........
XXXXXXX...XXXXXXX...
....XG........XG....
XX..XGX...XX..XGX...
....XXX.......XXX...
XX...XX...XX...XX.K.
S...................
XX...XX...XX...XX...