10 10
......X..T
XX...XX...
X........X
XXXXXXX...
....XG...X
XX..XGX...
....XXX...
XX...XX.K.
S.........
XX...XX..X
